111111111111
1P000000C001
100000000101
101110111011
1011C0001101
100010010001
100001100001
100010000001
100010000001
100000110001
100000E00001
111111111111