111111111111111
1P0000000000001
101C0000000C101
101000000001011
101010000C01C01
10001C000001001
101010000001001
101E00000000101
101000000000001
1C10000C0000001
111111111111111