1111111111111
1P000C00000E1
1001111011101
101000C000101
1001101111001
101000C000101
1001111111001
101C000000101
1000111111001
1010000000101
1C011111110C1
1C01000001C01
1111111111111
