1111111111111111111
1P000000000000000E1
1000111111111110001
101C0000000000C1001
1000111111111110001
101C0000000000C1001
1000111111111110001
101C0000000000C1001
1000111111111110001
101C0000000000C1001
1000001111111000001
1000000000000000001
100C0C0000000C0C001
1000001111111000001
1000001000001000001
1000001000001000001
1111111111111111111