11111111111111111
1P0C0000C00000001
10111011101110101
100C0000C000C0011
10101011110101001
100011000000C0101
10101010011101001
1000C000000000101
101111011110101E1
1C000000C00000001
10101011110101001
1000C100C00101001
11111111111111111
